

sample.txt
"a"	["www.yellowhelloworld.com", "www.worldhello.com", "www.helloworld.com"]
"are"	["www.lastbutnotleast.com"]
"by"	["www.lastbutnotleast.com"]
"come"	["www.lastbutnotleast.com"]
"different"	["www.yellowhelloworld.com"]
"file"	["www.worldhello.com", "www.helloworld.com"]
"good"	["www.yellowhelloworld.com", "www.lastbutnotleast.com"]
"hard"	["www.lastbutnotleast.com"]
"hello"	["www.helloworld.com"]
"is"	["www.yellowhelloworld.com", "www.worldhello.com", "www.helloworld.com"]
"text"	["www.yellowhelloworld.com"]
"the"	["www.worldhello.com"]
"thing"	["www.yellowhelloworld.com"]
"things"	["www.lastbutnotleast.com"]
"this"	["www.worldhello.com", "www.helloworld.com"]
"to"	["www.lastbutnotleast.com", "www.worldhello.com"]
"world"	["www.worldhello.com", "www.helloworld.com"]

sample2.txt
"friend"	["www.thisisanotherwebsite.com"]
"from"	["www.thisisanotherwebsite.com"]
"fun"	["www.wowawebsite.com"]
"good"	["www.thisisanotherwebsite.com"]
"is"	["www.wowawebsite.com", "www.thisisawebsite.com"]
"more"	["www.thisisawebsite.com"]
"our"	["www.thisisanotherwebsite.com"]
"python"	["www.wowawebsite.com", "www.thisisanotherwebsite.com"]
"sample"	["www.thisisawebsite.com"]
"text"	["www.wowawebsite.com", "www.thisisawebsite.com"]
"this"	["www.wowawebsite.com", "www.thisisawebsite.com"]

sample3.txt
"another"	["www.morewebsites.com"]
"bash"	["www.onwardtovictory.com"]
"can"	["www.runningoutofnames.com"]
"example"	["www.morewebsites.com"]
"files"	["www.onwardtovictory.com"]
"for"	["www.morewebsites.com"]
"is"	["www.morewebsites.com"]
"it"	["www.runningoutofnames.com"]
"map"	["www.morewebsites.com"]
"multiple"	["www.onwardtovictory.com"]
"on"	["www.onwardtovictory.com"]
"program"	["www.runningoutofnames.com"]
"python"	["www.runningoutofnames.com"]
"reduce"	["www.runningoutofnames.com"]
"scripting"	["www.onwardtovictory.com"]
"show"	["www.runningoutofnames.com"]
"that"	["www.runningoutofnames.com"]
"the"	["www.morewebsites.com"]
"this"	["www.morewebsites.com"]
"to"	["www.runningoutofnames.com"]
"using"	["www.onwardtovictory.com"]
"work"	["www.runningoutofnames.com"]
"yet"	["www.morewebsites.com"]
